111111111111111
10C000010C001E1
101011010110101
101010C1010C001
101010110111111
1P1C10000C0C001
111111111111111
