11111111111111
10000000000001
10C00C00C00C01
1000000P000001
10P00000000001
11111111111111