11111111111111
10E00000000001
10C00C00C00C01
100000000000011
10P00000000001111
111111111111111