11111111111111
10E10000000001
11100C00C00C01
10000000000001
10P00000000001
11111111111111
