11111111111111
10E10000000001
11111C00C00C01
10000000000001
10P01111111111
11111111111111
