1111111111111111111111111111111111
1E0000000000000C00000C000000000001
1011111111111111111111111111110101
101001C01010101C01100100C000010101
1P0000000C00C0000000000000000000C1
1111111111111111111111111111111111
